ART CREDITS:
Base:
	- Almaty: knightmare13 (Janybek Khan)
	- Antananarivo: Nutty (Ranavalona I)
		[alt] Antananarivo: TPangolin (Andrianampoinimerina)
	- Antwerp: janboruta (Robert III)
	- Belgrade: janboruta (Karadorde Petrovic)
	- Bogota: Leugi (Simon Bolivar)
	- Bratislava: J. Kohler/Nutty (Svatopluk I)
	- Brussels: janboruta (Leopold II)
	- Bucharest: janboruta (Vlad III)
	- Budapest: janboruta (Stephen I)
	- Buenos Aires: Leugi (Eva Peron)
		[alt] Buenos Aires: Leugi (Don Jose de San Martin)
	- Byblos: LastSword (Ahiram)
	- Cahokia: H. Roe/Nutty (Birdman)
		[alt] Cahokia: H. Roe/TPangolin (Birdman)
	- Cape Town: janboruta (Jan van Riebeeck)
	- Colombo: knightmare13 (D.S Senanayake)
		[old] Dublin: B. Mulrenin/Nutty (Daniel O'Connell)
		[old] Edinburgh: LastSword (James VI)
	- Florence: sukritact (Lorenzo de'Medici)
	- Geneva: janboruta (John Calvin)
	- Genoa: janboruta (Andrea Doria)
	- Hanoi: davey_henninger (Ly Thai To)
		[alt] Hanoi: knightmare13 (Ho Chi Minh)
		[old] Helsinki: Hypereon (Gustaf Mannerheim)
	- Hong Kong: TPangolin (Kai Ho)
	- Ife: janboruta (Akinmoyero)
	- Jerusalem: Leugi (Solomon)
	- Kabul: LastSword (Ahmad Shah Durrani)
		[alt] Kabul: TPangolin (Ahmad Shah Durrani)
	- Kathmandu: Leugi (Tribhuvan)
	- Kiev: janboruta (Yaroslav)
	- Kuala Lumpur: TPangolin (Yap Ah Loy)
	- Kyzyl: Nutty (Khertek Anchimaa-Toka)
	- La Venta: LastSword (Po Ngbe)
		[alt] La Venta: Leugi (Po Ngbe)
	- Lhasa: sukritact (Thubten Gyatso)
		[old] Lisbon: janboruta (Joao II)
	- Malacca: TPangolin (Panameswara)
		[alt] Malacca: Nutty (Abdul Halim)
	- Manila: knightmare13 (Jose Rizal)
	- Mbanza Kongo: Leugi (Njinga Mbande)
	- Melbourne: TPangolin (John Batman)
	- Milan: janboruta (Gian Galeazzo Visconti)
	- Mogadishu: TPangolin (Aden Adde)
	- Mombasa: knightmare13 (Jomo Kenyatta)
	- Monaco: knightmare13 (Rainier III)
	- Ormus: knightmare13 (Qaboos bin Said)
	- Panama City: Leugi (Victoriano Lorenzo)
	- Prague: janboruta (Wenceslaus II)
	- Quebec City: davey_henninger (John A. MacDonald)
	- Ragusa: Nutty (Auguste de Marmont)
	- Riga: TPangolin (Janis Cakste)
	- Samarkand: M. Gerasimov/LastSword (Timur)
		[alt] Samarkand: Tomatekh (Timur)
	- Sidon: Leugi (Eshmunazar II)
	- Singapore: TPangolin (Lee Kuan Yew)
		[alt] Singapore: adan_eslavo (Thomas Stamford Raffles)
	- Sofia: D. Giudjenov/Nutty (Simeon I)
		[alt] Sofia: D. Giudjenov/TPangolin (Simeon I)
	- Sydney: TPangolin (Arthur Phillip)
		[alt] Sydney: TPangolin (Henry Parkes)
	- Tyre: LastSword (Hiram I)
	- Ur: janboruta (Eannatum)
	- Valletta: TPangolin (Giovanni Paolo Lascaris)
	- Vancouver: TPangolin (Mackenzie King)
	- Vatican City: janboruta (Pius IX)
	- Vilnius: LastSword (Gediminas)
	- Wellington: JFD (Richard Seddon)
		[alt] Wellington: TPangolin (Henry Sewell)
	- Wittenberg: janboruta (Frederick III)
	- Yerevan: Leugi (Tigranes II)
	- Zanzibar: sukritact (Majid bin Said)
	- Zurich: JFD (Guillaume-Henri Dufour)
		[alt] Zurich: Krateng (Matthaus Schiner)
		[alt] Zurich: G. Closs/TPangolin (Rudolf Brun)

UCS compatibility part 1:
	- Armagh: Mosile (Saint Patrick)
	- Auckland: from Wellington - TPangolin (Henry Sewell)
	- Clermont: Mosile (pope Urban II)
	- Granada: Mosile (Muhammad I ibn Yusuf)
	- Honduras: Mosile (Manuel Bonilla Chirinos)
	- Leluh: Gedemo (Olosohpa)
	- Muscat: janboruta (Saif bin Sultan)

UCS compatibility part 2:
	- Chevak: Gedemo (Apanuugpak)
	- Douala: Mosile (Ahmadou Ahidjo)
	- Gwynedd: janboruta (Owain Glyndwr)
	- Laconia: janboruta (Leonidas)
	- Managua: Mosile (Anastasio Somoza Garcia)
	- Muisca: Leugi (Nemequene)
	- Odenso: Hypereon (Urho Kaleva Kekkonen)
	- Phanoteus: Mosile (Onomarchus)
	- Santo Domingo: Mosile (Juan Pablo Duarte)
	- Yangcheng: janboruta (Yu)

UCS compatibility part 3:
    - Ambracia: @Danmacsch (Pyrrhus)
    - Djibouti: @adan_eslavo (Hassan Gouled Aptidon)
    - Dodoma: @Danmacsch (Ali Hassan Mwinyi)
    - Faya: @adan_eslavo (Idriss Deby)
    - Kigali: @Danmacsch (Kigeli IV Rwabugiri)
    - Nairobi: @Danmacsch (Jomo Kenyatta)
    - Quelimane: @adan_eslavo (Manuel de Araújo)
    - Sierra Leone: @adan_eslavo (Sir Milton Margai)
    - Surrey: @adan_eslavo (Aethelwulf)

Civilizations (4UC):
	- Israel: Jerusalem ==> Balkh: tarcisiocm (Demetrius I)
	- Sumer: Ur ==> Skara Brae: Firebug (Oengus mac Fergusa)
	- the Timurids: Samarkand ==> Sanaa: adan_eslavo (Yahya)
	- the Papal States: Vatican ==> Karyes: janboruta (Constantine I)
	- Canada: Vancouver ==> St. John's: adan_eslavo (William Lyon Mackenzie King)
			  Quebec City ==> Honiara: adan_eslavo (sir Peter Kenilorea)
	- Tibet: Lhasa ==> Sarnath: LastSword (Ashoka)
	- Flanders: Brussels ==> Luxembourg: DJSHenninger (Ermesinde II)
	- Durrani: Kabul ==> Thimphu: janboruta (Jigme Dorji Wangchuck)